..............................
............................D.
..............FF.........22222
.K...............2222222211111
2222222222222........111111111
11111111111112................
.......F...11122............F.
P....F...F........222...222222
22222222222222222211111...F.11
111111111111111111111111111111