..............................
...........F..............D...
........................22222.
.......................2111112
.......22.....2........1......
....2221......12222...........
2...............111222222222.F
1......................1111122
1.22222......................1
..11111222.....2222...........
.......F.......1..............
.......................222....
.P...F...F........222221112..2
2222222222222222221111.K....11
111111111111111111111111111111